0 0 2 2 2 0 0 0
0 0 2 3 2 0 0 0
0 0 2 1 2 2 2 2
2 2 2 4 1 4 3 2
2 3 1 4 5 2 2 2
2 2 2 2 4 2 0 0
0 0 0 2 3 2 0 0
0 0 0 2 2 2 0 0