0 0 2 2 2 2 2 2
0 0 2 1 1 1 1 2
2 2 2 4 4 4 1 2
2 5 1 4 3 3 1 2
2 1 4 3 3 3 2 2
2 2 2 2 1 1 2 0
0 0 0 2 2 2 2 0