0 0 0 0 0 0 2 2 2 2 0 0 0 0 0
0 0 0 0 0 0 2 1 1 2 2 2 2 2 2
0 0 0 0 0 0 2 1 1 1 1 2 1 1 2
0 0 0 0 0 0 2 1 4 4 1 1 1 1 2
2 2 2 2 2 2 2 4 2 1 1 2 1 1 2
2 1 1 2 3 1 3 3 1 2 2 2 4 2 2
2 1 1 2 3 2 6 3 4 1 1 1 1 1 2
2 1 1 2 3 2 3 6 2 1 2 1 1 1 2
2 1 4 4 3 3 3 3 2 1 2 2 2 2 2
2 1 5 4 1 2 1 2 2 1 2 0 0 0 0
2 1 4 4 4 2 1 1 1 1 2 0 0 0 0
2 1 1 1 1 2 2 2 2 2 2 0 0 0 0
2 2 2 2 2 2 0 0 0 0 0 0 0 0 0