2 2 2 2 2 2 2 2 2 2 2 2 2
2 1 1 4 1 4 1 4 3 6 3 3 2
2 1 4 1 4 1 4 1 6 3 3 3 2
2 1 1 4 1 4 1 4 3 6 3 3 2
2 1 4 1 4 1 4 1 6 3 3 3 2
2 1 1 4 1 4 1 4 3 6 3 3 2
2 1 4 1 4 1 4 1 6 3 3 3 2
2 1 1 4 1 4 1 4 3 6 3 3 2
2 1 4 1 4 1 4 1 6 3 3 3 2
2 1 1 4 1 4 1 4 3 6 3 3 2
2 5 4 1 4 1 4 1 6 3 3 3 2
2 2 2 2 2 2 2 2 2 2 2 2 2