2 2 2 2 2 2 2 2 2 2 2
2 1 1 1 1 2 1 1 1 1 2
2 1 4 5 4 4 4 4 4 1 2
2 1 1 1 1 1 1 1 1 1 2
2 2 2 2 2 1 2 2 2 2 2
0 0 0 2 3 1 1 2 0 0 0
0 0 0 2 3 1 1 2 0 0 0
0 0 0 2 3 3 3 2 0 0 0
0 0 0 2 3 1 1 2 0 0 0
0 0 0 2 2 2 2 2 0 0 0