0 0 2 2 2 2 2 0 0
0 0 2 1 5 1 2 0 0
0 0 2 1 4 1 2 0 0
2 2 2 1 3 1 2 2 2
2 1 1 1 6 1 1 1 2
2 1 6 6 6 6 6 1 2
2 1 1 1 6 1 1 1 2
2 2 2 4 6 4 2 2 2
0 0 2 1 3 1 2 0 0
0 0 2 1 6 1 2 0 0
0 0 2 1 3 1 2 0 0
0 0 2 2 2 2 2 0 0