2 2 2 2 2 2 2 2 2 2 2 2
2 1 1 1 1 3 3 3 1 4 1 2
2 1 4 4 4 6 6 6 1 4 5 2
2 1 1 1 1 3 3 3 1 4 1 2
2 2 2 2 2 2 2 2 2 2 2 2