2 2 2 2 2 0 0 0 0 0
2 1 1 1 2 2 2 2 2 2
2 1 4 1 3 3 1 4 1 2
2 2 4 1 3 3 4 4 5 2
0 2 1 1 3 3 1 4 1 2
0 2 2 2 2 2 2 2 2 2