2 2 2 2 2 2 2
2 1 1 6 1 1 2
2 1 5 3 4 1 2
2 1 4 3 1 1 2
2 6 3 6 6 6 2
2 1 1 6 1 1 2
2 1 4 6 4 1 2
2 1 1 3 1 1 2
2 2 2 2 2 2 2