2 2 2 2 2 2 2 2 0
2 1 1 1 1 1 1 2 0
2 1 2 4 4 1 1 2 0
2 1 3 3 3 2 1 2 0
2 2 3 3 3 4 1 2 2
0 2 1 2 2 1 4 1 2
0 2 4 1 1 4 1 1 2
0 2 1 1 2 1 1 5 2
0 2 2 2 2 2 2 2 2