0 0 0 0 0 0 0 0 0 2 2 2 2 2 0 0
0 0 0 0 0 0 0 0 0 2 1 1 1 2 0 0
2 2 2 2 2 2 2 2 2 2 1 6 1 2 2 2
2 1 1 1 1 1 1 1 1 1 1 3 1 1 1 2
2 1 4 4 4 4 6 6 6 6 4 3 3 3 5 2
2 1 1 1 1 1 1 1 1 1 1 3 1 1 1 2
2 2 2 2 2 2 2 2 2 2 1 6 1 2 2 2
0 0 0 0 0 0 0 0 0 2 1 1 1 2 0 0
0 0 0 0 0 0 0 0 0 2 2 2 2 2 0 0