2 2 2 2 0 0 0 0 0 0 2 2 2 2
2 3 3 2 2 2 2 2 2 2 2 3 3 2
2 6 3 6 3 3 3 3 3 6 3 6 3 2
2 1 4 1 4 1 4 1 4 1 4 1 4 2
2 4 1 4 1 4 5 4 1 4 1 4 1 2
2 1 4 1 4 1 4 1 4 1 4 1 4 2
2 4 1 4 1 4 1 4 1 4 1 4 1 2
2 3 6 3 6 3 3 3 3 3 6 3 6 2
2 3 3 2 2 2 2 2 2 2 2 3 3 2
2 2 2 2 0 0 0 0 0 0 2 2 2 2