2 2 2 2 2 2 0 0 0
2 1 1 1 1 2 0 0 0
2 1 4 1 1 2 2 2 2
2 1 4 6 3 3 6 1 2
2 1 6 3 3 6 4 1 2
2 2 2 2 1 1 4 1 2
0 0 0 2 1 5 1 1 2
0 0 0 2 2 2 2 2 2