0 0 0 2 2 2 2 2 0
2 2 2 2 3 1 1 2 2
2 1 4 3 4 3 1 1 2
2 5 4 2 1 2 4 1 2
2 1 4 3 1 3 1 1 2
2 2 2 2 4 2 4 1 2
0 0 2 3 1 3 1 1 2
0 0 2 2 2 2 2 2 2