0 2 2 2 2 0 0 2 2 2 2 2 2
0 2 1 1 2 2 2 2 1 1 1 1 2
2 2 6 1 1 1 6 1 6 6 1 1 2
2 1 4 1 6 1 1 1 1 6 2 1 2
2 1 3 1 1 1 2 2 2 1 1 1 2
2 2 2 2 2 2 1 1 1 2 5 2 2
2 1 6 1 3 1 6 1 1 6 6 1 2
2 1 1 1 2 1 1 1 2 1 1 1 2
2 2 6 1 1 1 6 1 2 4 2 1 2
0 2 1 1 2 2 2 2 2 1 1 1 2
0 2 2 2 2 0 0 0 2 2 2 2 2