0 0 0 0 0 0 0 0 0 2 2 2 2 2 0 0
0 0 0 0 0 0 0 0 2 1 1 1 1 1 2 0
0 0 0 0 0 0 0 2 1 1 4 2 2 1 1 2
0 0 0 0 0 0 2 1 1 2 1 1 1 4 1 2
2 0 0 2 0 0 2 1 2 1 1 2 1 2 1 2
0 2 0 2 0 0 2 1 4 1 4 1 1 4 1 2
0 0 2 2 2 2 2 2 2 1 2 4 2 1 1 2
0 0 2 1 1 4 1 4 1 1 1 1 1 1 2 0
0 0 2 5 3 3 4 1 6 6 3 2 2 2 0 0
0 0 0 2 3 3 3 3 3 3 2 2 2 2 2 0
0 0 0 0 2 2 2 2 2 2 2 2 2 2 2 2