2 2 2 2 2 2 2 2
2 1 1 2 1 1 1 2
2 1 4 3 3 4 1 2
2 5 4 3 6 1 2 2
2 1 4 3 3 4 1 2
2 1 1 2 1 1 1 2
2 2 2 2 2 2 2 2