0 0 0 0 0 2 2 2 2 2
0 2 2 2 2 2 1 1 1 2
0 2 1 3 3 1 4 2 1 2
0 2 1 2 3 6 1 1 1 2
2 2 1 6 3 2 4 1 2 2
2 1 4 1 1 4 1 1 2 0
2 1 1 1 2 2 1 5 2 0
2 2 2 2 2 2 2 2 2 0