2 2 2 2 2 2 2 2 2 2 2 2 2 2
2 3 1 1 1 1 1 1 1 1 1 1 1 2
2 3 4 1 4 1 4 1 4 1 4 1 1 2
2 3 2 2 2 2 2 2 2 2 2 1 1 2
2 3 2 3 6 1 4 1 3 3 4 6 2 2
2 3 2 1 4 1 4 1 6 3 4 5 2 0
2 3 2 3 1 1 4 1 3 3 4 4 2 0
2 3 2 2 2 2 2 2 2 2 2 3 2 0
2 3 1 1 1 1 1 1 1 1 1 1 2 0
2 3 2 4 2 4 2 4 2 4 2 4 2 0
2 3 1 1 1 1 1 1 1 1 1 1 2 0
2 2 2 2 2 2 2 2 2 2 2 2 2 0