2 2 2 2 2 2 2
2 3 1 3 1 3 2
2 1 4 4 4 1 2
2 3 4 5 4 3 2
2 1 4 4 4 1 2
2 3 1 3 1 3 2
2 2 2 2 2 2 2