0 0 0 0 0 2 2 2 2 2 2 0 0 0
0 0 0 2 2 2 1 1 1 1 2 2 0 0
0 0 0 2 1 1 1 2 2 1 1 2 0 0
0 2 2 2 4 2 2 1 1 2 1 2 0 0
2 2 1 1 1 1 1 3 3 2 1 2 0 0
2 1 1 4 2 4 2 6 3 2 1 2 0 0
2 1 4 4 5 1 2 3 6 2 1 2 2 2
2 1 1 4 4 1 2 3 3 2 1 1 1 2
2 2 1 1 1 1 2 3 3 4 1 1 1 2
0 2 2 2 4 2 2 3 1 2 1 2 2 2
0 0 0 2 1 1 2 2 2 1 1 2 0 0
0 0 0 2 2 1 1 1 1 1 2 2 0 0
0 0 0 0 2 2 2 2 2 2 2 0 0 0